1111111
1P00011
1111011
1E00C11
1111111