111111111
1P0000011
11110C011
1000C0011
1011CCCC1
101100CE1
111111111