111111111
1P0000011
10110C011
1E00C0011
1011CCC11
101100011
111111111
111111111