1111111
1P00011
1111011
1E0CC01
1111111