111111111
1P1000011
11110C011
1E00C0011
1011CCC11
101100011
111111111